region,region_id,Black,Green,Gray,Red,RedandGray
Aleutian Islands,1,48,8,22,32,54
Arctic,2,3,13,8,8,16
Bristol Bay,3,6,5,7,7,14
Cook Inlet,9,72,302,213,474,687
Copper River,5,0,31,62,112,174
Kodiak,6,75,22,25,67,92
Norton Sound,10,2,9,19,76,95
Prince William Sound,11,4,6,17,16,33
Southeast,12,35,201,193,296,489
Yukon,13,30,123,72,206,278
Chignik,4,0,0,0,0,0
Kotzebue,7,0,0,0,0,0
Kuskokwim,8,0,0,0,0,0
